1111111111122211111111111
10000000000222000000000B1
1000000000002000000000001
1000200011000001100002001
100020J01100J00110J002001
1000200011000001100002001
1000S00000002000000000001
1B00S00000022200000000001
1111111111122211111111111