1111111111111111111111111
1B0000000000000000000S0B1
100000000000000000000S001
1000S000SS00000SS0000S001
1000S000SS00J00SS0000S001
1000S000SS22022SS0000S001
1000S00000000000000000001
1B00S000000000000000000B1
1111111111111111111111111