1111111111122211111111111
1000000000022200000000001
1000000000002000000000001
1000200011000001100002001
100020J01100J00110J002001
1000200011000001100002001
1000000000002000000000001
1000000000000000000000001
1111SS1111100011111SS1111
1111SS1111100011111SS1111
1000000000000000000000001
1000000000002000000000001
1000200011002001100002001
1000200011002001100002001
1000200011002001100002001
1000000000002000000000001
1B000000B0000000B000000B1
1111111111111111111111111