111111111111111111111111111
100000000000000000000000001
100000000000000000000000001
1SSS11BB11000000011BB11SSS1
1000111111SSSSSSS1111110001
1SSS1100110000000110011SSS1
100000000000000000000000001
100000000000000000000000001
100000002222222222000000001
100000002222222222000000001
100002222222222222222000001
100002220000000000222000001
100002220000JJ0000222000001
100002220000JJ0000222000001
100002220000000000222000001
1S00SSSSSSSS00SSSSSSSSS00S1
100000000000000000000000001
111111111111111111111111111